################################################################
#                                                              #
# ############################################################ #
#                                                              #
#     ##################### ###########################        #
#     #################################################        #
#                     @                                        #
#############################################################  #
#                                                              #
#     ##################### ###########################        #
#                                                              #
# ############################################################ #
#                                                              #
################################################################